aa|Albânia
abc|Alberta
ae|Algeria
af|Afeganistão
ag|Argentina
ai|Armenia (Republica)
aj|Azerbaijan
aku|Alasca
alu|Alabama
am|Anguilla
an|Andorra
ao|Angola
aq|Antigua e barbuda
aru|Arcansas
as|Samoa Americana
at|Austrália
au|Austria
aw|Aruba
ay|Antártica
azu|Arizona
ba|Bahrain
bb|Barbados
bba|Bahia - Brasil
bcc|Columbia Britânica
bd|Burundi
be|Bélgica
bes|Espírito Santo - Brasil
bf|Bahamas
bg|Bangladeste
bh|Belize
bi|Território Britânico do Oceano Índico
bl|Brasil
bm|Ilhas das Bermudas
bn|Bosnia e Hercegovina
bo|Bolivia
bp|Ilhas Salomão
bpr|Paraná - Brasil
br|Burma
brj|Rio de Janeiro - Brasil
brs|Rio Grande do Sul
bs|Botsuana
bsc|Santa Catarina - Brasil
bsp|São Paulo - Brasil
bt|Butão
bu|Bulgária
bv|Ilha Bouvet
bw|Belorússia
bx|Brunei
cau|California
cb|Camboja
cc|China
cd|Chad
ce|Sri Lanka
cf|Congo (Brazzaville)
cg|Congo (República Democrática)
ch|China (República : 1949- )
ci|Croácia
cj|Ilhas Cayman
ck|Colômbia
cl|Chile
cm|Camarôes
cou|Colorado
cq|Comoros
cr|Costa Rica
ctu|Connecticut
cu|Cuba
cv|Cabo Verde
cw|Ilhas Cook
cx|República da Africana Central
cy|Chipre
d| (Oceano Índico)
dcu|Distrito de Columbia
deu|Delaware
dk|Dinamarca
dm|Benin
dq|Dominica
dr|República Dominicana
ea|Eritrea
ec|Equador
eg|Guinea Equatorial
enk|Inglaterra
er|Estônia
es|El Salvador
et|Etiópia
fa|Ilhas Faroe
fg|Guiana Francesa
fi|Finlândia
fj|Fiji
fk|Ilhas Falkland
flu|Flórida
fm|Micronésia (Estados Confederados)
fp|Polinésia Francesa
fr|França
fs|Terras do sul e antárctica francesas
ft|Djibouti
gau|Geórgia
gb|Kiribati
gd|Granada
gh|Gana
gi|Gibraltar
gl|Groelândia
gm|Gâmbia
go|Gabão
gp|Guadeloupe
gr|Grécia
gs|Geórgia (Republica)
gt|Guatemala
gu|Guam
gv|Guinea
gw|Alemanha
gy|Guiana
gz|Faixa de Gaza
hiu|Hawaí
hm|Ilhas Heard e McDonald
ho|Honduras
ht|Haiti
hu|Hungria
iau|Iowa
ic|Islândia
idu|Idaho
ie|Irlanda
ii|India
ilu|Illinois
inu|Indiana
io|Indonésia
iq|Iraque
ir|Irã
is|Israel
it|Itália
iv|C¶te d'Ivoire
iy|Zona Neutra Arábia Iraque-Saudita
ja|Japão
ji|Atol Johnston
jm|Jamaica
jo|Jordânia
ke|Quênia
kg|Kyrgyzstan
kn|Coréia (Norte)
ko|Coréia (Sul)
ksu|Kansas
ku|Kuwait
kyu|Kentucky
kz|Casaquistão
lau|Louisiana
lb|Libéria
le|Líbano
lh|Principado de Liechtenstein
li|Lituânia
lo|Lesoto
ls|Laos
lu|Luxemburgo
lv|Letônia
ly|Líbia
mau|Massachusetts
mbc|Manitoba
mc|Mônaco
mdu|Maryland
meu|Maine
mf|Maurício
mg|Madagascar
miu|Michigan
mj|Montserrat
mk|Oman
ml|Mali
mm|Malta
mnu|Minnesota
mou|Missouri
mp|Mongólia
mq|Martinique
mr|Marrocos
msu|Mississippi
mtu|Montana
mu|Mauritânia
mv|Moldova
mw|Malawi
mx|México
my|Malásia
mz|Mossambique
na|Holanda Antilhas
nbu|Nebrasca
ncu|Carolina do Norte
ndu|Dakota do Norte
ne|Países Baixos
nfc|Newfoundland (Ilha Canadense)
ng|Niger
nhu|Nova-Hampshire
nik|Irlanda do Norte
nju|Nova Jersey
nkc|Nova Brunswick
nl|Nova Caledonia
nmu|Novo México
nn|Vanuatu
no|Noruega
np|Nepal
nq|Nicarágua
nr|Nigéria
nsc|Nova Scotia
ntc|Territórios do Noroestes
nu|Nauru
nuc|Nunavut
nvu|Nevada
nw|Ilhas Mariana do Norte
nx|Ilhas Norfolk
nyu|Nova York (Estado)
nz|Nova Zelândia
ohu|Ohio
oku|Oklahoma
onc|Ontário
oru|Oregon
ot|Mayotte
pau|Pennsilvânia
pc|Ilhas Pitcairn
pe|Peru
pf|Ilhas Paracel
pg|Guinea Bissau
ph|Filipinas
pic|Ilha Príncipe Edward
pk|Paquistão
pl|Polônia
pn|Panamá
po|Portugal
pp|Papua-Nova Guiné
pr|Porto Rico
pw|Palau
py|Paraguai
qa|Qatar
quc|Quebec (Província)
re|Runion
rh|Zimbabwe
riu|Ilha Rhode
rm|Romênia
ru|Rússia (Federação)
rw|Ruanda
sa|África do Sul
scu|Carolina do Sul
sdu|Dakota do Sul
se|Seychelles
sf|São Tomé e Principe
sg|Senegal
sh|África do Norte Espanhola
si|Singapura
sj|Sudão
sl|Serra Leoa
sm|San Marino
snc|Saskatche
so|Somália
sp|Espanha
sq|Suazilândia
sr|Suriname
ss|Sahara Ocidental
stk|Escócia
su|Arábia Saudita
sw|Suécia
sx|Namibia
sy|Síria
sz|Suíça
ta|Tajikistan
tc|Ilhas Turcas e Caicos
tg|Togo
th|Tailândia
ti|Tunísia
tk|Turcomenistão
tl|Tokelau
tnu|Tennessee
to|Tonga
tr|Trinidad e Tobago
ts|Emirados Árabes Unidos
tu|Turquia
tv|Tuvalu
txu|Texas
tz|Tanzânia
ua|Egito
uc|Estados Unidos Misc.Ilhas do Cararibe
ug|Uganda
uik|Ilhas do Reino Unido
un|Ucrânia
up|Estados Unidos Misc. Ilhas do Pacífico
utu|Utah
uv|Burkina Faso
uy|Uruguai
uz|Uzbequistão
vau|Virgínia
vb|Ilhas Virgens Britânicas
vc|Cidade do Vaticano
ve|Venezuela
vi|Ilhas Virgens dos Estados Unidos
vm|Vietnã
vp|Vários lugares
vtu|Vermont
wau|Washington (Estado)
wf|Wallis e Futuna
wiu|Wisconsin
wj|Margem Ocidental do Rio Jordão
wk|Ilha Wake
wlk|Gales
ws|Samoa
wvu|Oeste da Virgínia
wyu|Wyoming
xa|Ilhas Natal
xb|Ilhas Cocos (Keeling)
xc|Maldives
xd|Saint Kitts-Nevis
xe|Ilhas Marshall
xf|Ilhas Midway
xh|Niue
xj|Santa Helena
xk|Santa Lucia
xl|Saint Pierre and Miquelon
xm|São Vicente e os Grenadinos
xn|Macedonia
xo|Eslováquia
xp|Ilhas Spratly
xr|República Tcheca
xs|Georgia do Sul e as Ilhas Sandwich do Sul
xv|Eslovênia
xx|Sem local, desconhecido, ou indeterminado
xxc|Canadá
xxk|Reino Unido
xxu|Estados Unidos
ye|Iêmen
ykc|Território de Yukon
yu|Jugoslávia
za|Zâmbia
